1111111111111111
0010001000000001
1010101110111101
1010100010000101
1000000110110101
1011111100010101
1000000101110001
1111110101011111
1000000101000001
1101110101011101
1000010100010001
1011110101110101
1010100100010101
1010110110110111
1000010000010001
1111111111111101